111111111111111111
1CG100110C100010C1
100000E10110001001
100100110000101001
100100000011100001
100001011000001001
1111010C1011111011
1C00011010G01C0001
110101000010000101
110101111011111101
10C100C00010C1P001
111111111111111111
