111111111111111111111111
1CG100110C1000C1000010C1
100000E10110000000001001
100100110000010000101001
100100000011110G01100001
100001011000010000001001
111101001011110001111011
100101001000010100000001
100100001011010100000001
100001011C10010100G00001
111101001110010101111001
1000011010G0010000000001
110101000010010100000101
110101111010010101111101
10C100C00010000100C1P001
111111111111111111111111
