111111111111111111111111
1CG100100C1000C1000010C1
100000E10110000000001001
100100100000010000101001
100100001011110G01100001
100000011000010000001001
111100001011110001111011
100100001000010100000001
100100001011010100000001
100001011C10010100G00001
111101001110010101111001
1000010010G0010000000001
100101000010010100000101
100101110010010101111101
10C100001010000100C1P001
111111111111111111111111
