1111111111111
1001000000001
1000011011001
1111000G00001
1001111011001
1011000G00001
1000011011001
1011000001001
1P00011101001
10C0C0E000001
1111111111111
