1111111111111
10010000000C1
10C0011111001
10010000000C1
10C0011111001
1001000G000C1
1000011111001
10010000000C1
1000011111001
100P11E000001
1111111111111
