1111111111111
10010000000C1
10C0011011001
11110G00C0001
10C1111011001
1011000GC0001
1000011111001
10110000010C1
1P00011101001
10C001E000001
1111111111111
